....c....
.1.....c.
....w....
...w...w.
c.w...w.c
.w...w...
....w....
.c.....2.
....c....
