.........
.1..c..c.
....w....
...w.....
.cw.c.wc.
.....w...
....w....
.c..c..2.
.........
