.........
.c..1..c.
.w..w..w.
.........
.........
.........
.........
.w..w..w.
.c..2..c.
.........
