....w...w....
.c..w...w..c.
.............
....w...w....
..c.w...w.c..
.............
....w...w....
.c..w...w..c.
....w...w....
.............
..c.w...w.c..
....w...w....
.............
.c..w...w..c.
....w...w....
