.........
.1..1..1.
.w..w..w.
.........
.........
.........
.........
.w..w..w.
.2..2..2.
.........
