.........
......c..
..1......
....www..
..www....
......c..
..c......
....www..
..www....
......2..
..c......
.........
