www........
w.......c..
..c..1....w
...........
....wwwww..
..www......
w......c..c
c..c......w
......www..
..wwwww....
...........
w....c..c..
..c.......w
........www
